
[
    [-0, -2, -2, -2, -3,-1, -4, -1, -5, -2, -1, -2, -0, -99],
    [-2, -2, -2, -2, -4, -2, -2, -1, -0, -99],
    [ -1,-4, -3, -2, -1, -0, -99],
    [-99],
    [-99],
    [-2, -2, -2, -2, -1, -0,-2, -99],
    [-2, -2, -5, -1, -1, -4,  -2, -1, -4, -1, -3,-99],
    [-2, -0,-2, -2, -2, -2, -2, -5, -2, -2, -99],
    [-99],
    [-1, -0, -2, -2, -2, -5, -1, -2, -2, -2,-4,-99],
    [-2, -2, -1, -0, -99],
    [-1, -4, -1, -2, -2, -0, -2, -2 ,-2, -2, -0,-99],
    [-99],
    [-2, -2, -2, -2, -2, -5, -1, -2, -2,-4,-99],
    [-99],
    [-2, -2, -2, -2, -2, -2, -0, -3, -1, -1, -3, -99],
    [-2, -4, -5, -2, -2, -2, -2, -2, -4, -2, -4, -99]
  ]